┌┬┬┬┬┬┬┬┬┬┬┬┬┬┬┬┬┬┐
├┼┼┼┼┼┼┼┼┼┼┼┼┼┼┼┼┼┤
├┼┼┼┼┼┼┼┼┼┼┼┼┼┼┼┼┼┤
├┼┼┼┼┼┼┼┼┼┼┼┼┼┼┼┼┼┤
├┼┼┼┼┼┼┼┼┼┼┼┼┼┼┼┼┼┤
├┼┼┼┼┼┼┼┼┼┼┼┼┼┼┼┼┼┤
├┼┼┼┼┼┼┼┼┼┼┼┼┼┼┼┼┼┤
├┼┼┼┼┼┼┼┼┼┼┼┼┼┼┼┼┼┤
├┼┼┼┼┼┼┼┼┼┼┼┼┼┼┼┼┼┤
├┼┼┼┼┼┼┼┼┼┼┼┼┼┼┼┼┼┤
├┼┼┼┼┼┼┼┼┼┼┼┼┼┼┼┼┼┤
├┼┼┼┼┼┼┼┼┼┼┼┼┼┼┼┼┼┤
├┼┼┼┼┼┼┼┼┼┼┼┼┼┼┼┼┼┤
├┼┼┼┼┼┼┼┼┼┼┼┼┼┼┼┼┼┤
├┼┼┼┼┼┼┼┼┼┼┼┼┼┼┼┼┼┤
├┼┼┼┼┼┼┼┼┼┼┼┼┼┼┼┼┼┤
├┼┼┼┼┼┼┼┼┼┼┼┼┼┼┼┼┼┤
├┼┼┼┼┼┼┼┼┼┼┼┼┼┼┼┼┼┤
├┼┼┼┼┼┼┼┼┼┼┼┼┼┼┼┼┼┤
└┴┴┴┴┴┴┴┴┴┴┴┴┴┴┴┴┴┘